year,team_id,team_name,wins,losses,ties,total_games
2013,30123,Academy of Art,4,13,1,18
2013,929,Adams St.,2,16,0,18
2013,3,Adelphi,3,13,0,16
2013,4,Adrian,6,13,1,20
2013,721,Air Force,10,9,4,23
2013,5,Akron,18,1,3,22
2013,10,Ala.-Huntsville,1,15,0,16
2013,14,Albany (NY),6,11,1,18
2013,2798,Albertus Magnus,15,4,3,22
2013,15,Albion,2,17,0,19
2013,16,Albright,8,10,1,19
2013,934,Alderson Broaddus,5,9,0,14
2013,18,Alfred,6,12,0,18
2013,19,Allegheny,13,4,1,18
2013,21,Alma,7,12,1,20
2013,938,Alvernia,14,7,3,24
2013,23,American,11,6,2,19
2013,22,American Int'l,5,11,2,18
2013,24,Amherst,17,0,3,20
2013,939,Anderson (IN),10,11,1,22
2013,13028,Anderson (SC),6,10,4,20
2013,26,Anna Maria,2,16,1,19
2013,27,Appalachian St.,8,7,4,19
2013,966,Arcadia,8,7,2,17
2013,725,Army,4,10,3,17
2013,35,Ashland,8,8,2,18
2013,36,Assumption,4,8,3,15
2013,38,Augsburg,11,5,2,18
2013,40,Augustana (IL),6,9,3,18
2013,42,Aurora,12,5,2,19
2013,953,Austin,9,9,2,20
2013,44,Averett,10,5,3,18
2013,45,Babson,13,4,3,20
2013,46,Baldwin Wallace,7,6,4,17
2013,958,Baptist Bible (PA),3,15,0,18
2013,962,Bard,3,14,2,19
2013,49,Barry,5,10,1,16
2013,15646,Barton,8,9,2,19
2013,58,Baruch,11,6,3,20
2013,50,Bates,4,8,2,14
2013,26107,Becker,2,16,0,18
2013,52,Bellarmine,10,5,3,18
2013,14927,Belmont,6,8,3,17
2013,2683,Belmont Abbey,6,10,0,16
2013,53,Beloit,11,5,1,17
2013,296,Benedictine (IL),4,13,0,17
2013,56,Bentley,10,5,2,17
2013,973,Berry,14,3,2,19
2013,59,Bethany (WV),5,12,1,18
2013,30038,Bethany Lutheran,9,11,1,21
2013,60,Bethel (MN),2,15,0,17
2013,62,Binghamton,6,11,1,18
2013,28593,Birmingham-So.,6,5,6,17
2013,64,Blackburn,7,10,1,18
2013,984,Bloomfield,7,6,3,16
2013,65,Bloomsburg,9,8,1,18
2013,987,Bluffton,2,14,0,16
2013,67,Boston College,8,6,5,19
2013,68,Boston U.,6,8,4,18
2013,69,Bowdoin,8,5,2,15
2013,71,Bowling Green,8,9,3,20
2013,72,Bradley,10,6,4,20
2013,73,Brandeis,18,3,1,22
2013,30094,Brevard,2,12,2,16
2013,74,Bridgeport,10,8,0,18
2013,75,Bridgewater (VA),10,8,0,18
2013,76,Bridgewater St.,9,9,1,19
2013,78,Brockport,8,8,1,17
2013,79,Brooklyn,13,5,3,21
2013,80,Brown,13,3,3,19
2013,81,Bryant,6,8,2,16
2013,83,Bucknell,7,8,5,20
2013,84,Buena Vista,5,11,1,17
2013,86,Buffalo,5,11,1,17
2013,85,Buffalo St.,1,16,1,18
2013,87,Butler,5,8,5,18
2013,2685,BYU-Hawaii,5,8,3,16
2013,362,LIU Post,18,1,0,19
2013,88,Cabrini,11,7,4,22
2013,105,Cal Lutheran,8,12,0,20
2013,90,Cal Poly,11,7,1,19
2013,91,Cal Poly Pomona,3,11,3,17
2013,94,Bakersfield,9,5,5,19
2013,95,Cal St. Chico,9,3,6,18
2013,92,Cal St. Dom. Hills,10,6,2,18
2013,98,Cal St. East Bay,5,8,5,18
2013,97,Cal St. Fullerton,8,12,1,21
2013,100,Cal St. L.A.,11,4,5,20
2013,30055,Cal St. Monterey Bay,3,12,0,15
2013,101,Cal St. Northridge,15,7,0,22
2013,93,Cal St. San B'dino,5,5,7,17
2013,103,Cal St. Stanislaus,12,5,3,20
2013,995,Caldwell,7,9,2,18
2013,107,California,8,7,3,18
2013,106,California (PA),11,6,2,19
2013,89,Caltech,0,19,0,19
2013,114,Calvin,16,4,1,21
2013,115,Campbell,12,5,2,19
2013,116,Canisius,8,7,2,17
2013,117,Capital,9,6,4,19
2013,118,Carleton,17,2,2,21
2013,119,Carnegie Mellon,13,4,1,18
2013,120,Carroll (WI),13,8,1,22
2013,1000,Carson-Newman,8,6,3,17
2013,121,Carthage,14,6,0,20
2013,122,Case,3,14,1,18
2013,123,Castleton,11,7,0,18
2013,1001,Catawba,9,7,3,19
2013,124,Catholic,13,6,0,19
2013,23624,Cazenovia,8,8,2,18
2013,480,CCNY,8,9,3,20
2013,125,Centenary (LA),6,13,0,19
2013,12884,Centenary (NJ),8,9,1,18
2013,126,Central (IA),9,10,2,21
2013,1004,Central Ark.,8,9,1,18
2013,127,Central Conn. St.,8,8,2,18
2013,132,Centre,15,4,3,22
2013,133,Chaminade,2,11,3,16
2013,134,Chapman,8,10,1,19
2013,1013,Charleston (WV),13,2,4,19
2013,458,Charlotte,15,4,3,22
2013,21323,Chestnut Hill,5,12,1,18
2013,137,Chicago,8,4,5,17
2013,8875,Chowan,2,16,0,18
2013,139,Chris. Newport,15,4,2,21
2013,1015,Christian Bros.,11,7,1,19
2013,140,Cincinnati,6,9,4,19
2013,142,Claremont-M-S,13,7,2,22
2013,145,Clark (MA),9,9,0,18
2013,146,Clarkson,2,12,3,17
2013,20576,Clayton St.,7,8,1,16
2013,147,Clemson,6,9,5,20
2013,148,Cleveland St.,11,6,3,20
2013,722,Coast Guard,13,6,2,21
2013,149,Coastal Caro.,20,3,2,25
2013,30083,Cobleskill St.,3,13,1,17
2013,150,Coe,5,12,1,18
2013,1023,Coker,12,4,1,17
2013,1014,Col. of Charleston,8,10,1,19
2013,151,Colby,4,8,2,14
2013,152,Colby-Sawyer,5,11,2,18
2013,153,Colgate,5,8,6,19
2013,11403,Colo. Christian,1,17,0,18
2013,154,Colorado Col.,14,5,3,22
2013,155,Colorado Mines,14,5,2,21
2013,2720,Colorado St.-Pueblo,6,7,5,18
2013,158,Columbia,4,8,4,16
2013,1028,Concord,5,11,2,18
2013,162,Concordia (NY),6,8,1,15
2013,24400,Concordia (TX),5,12,1,18
2013,1036,Concordia (WI),11,8,2,21
2013,160,Concordia Chicago,2,15,2,19
2013,161,Concordia-M'head,6,12,0,18
2013,164,UConn,17,4,1,22
2013,163,Connecticut Col.,5,4,6,15
2013,167,Cornell,15,2,0,17
2013,166,Cornell College,0,17,1,18
2013,169,Creighton,17,4,3,24
2013,30035,Crown (MN),6,11,2,19
2013,170,Curry,11,9,0,20
2013,1059,D'Youville,3,15,0,18
2013,1044,Dallas,5,10,2,17
2013,1045,Dallas Baptist,4,13,1,18
2013,2691,Daniel Webster,5,11,2,18
2013,172,Dartmouth,9,7,0,16
2013,173,Davidson,6,11,1,18
2013,174,Davis & Elkins,14,4,2,20
2013,175,Dayton,11,5,2,18
2013,1050,Defiance,3,15,1,19
2013,180,Delaware,4,11,4,19
2013,179,Delaware Valley,8,8,1,17
2013,181,Delta St.,8,11,1,20
2013,182,Denison,8,7,2,17
2013,183,Denver,11,6,3,20
2013,176,DePaul,4,10,3,17
2013,177,DePauw,14,2,5,21
2013,20,DeSales,9,6,3,18
2013,184,Detroit,10,9,0,19
2013,185,Dickinson,13,5,2,20
2013,186,Dist. Columbia,6,9,2,17
2013,30095,Dixie St.,5,11,2,18
2013,30118,Dominican (CA),9,7,2,18
2013,1332,Dominican (IL),18,3,1,22
2013,8956,Dominican (NY),10,5,4,19
2013,2692,Dowling,2,15,1,18
2013,189,Drake,6,11,4,21
2013,190,Drew,11,6,2,19
2013,191,Drexel,12,4,3,19
2013,1057,Drury,12,5,2,19
2013,192,Dubuque,11,6,1,18
2013,193,Duke,8,8,2,18
2013,194,Duquesne,7,12,1,20
2013,195,Earlham,3,10,5,18
2013,197,East Stroudsburg,3,12,2,17
2013,198,East Tenn. St.,10,6,4,20
2013,1062,East Tex. Baptist,4,10,1,15
2013,203,East. Mennonite,8,11,1,20
2013,8968,Eastern,9,5,1,15
2013,200,Eastern Conn. St.,17,2,1,20
2013,201,Eastern Ill.,3,13,1,17
2013,206,Eastern N.M.,10,7,1,18
2013,1064,Eastern Nazarene,7,9,2,18
2013,208,Eckerd,7,9,4,20
2013,1066,Edgewood,9,7,1,17
2013,211,Elizabethtown,9,7,3,19
2013,212,Elmhurst,9,10,0,19
2013,213,Elmira,13,7,0,20
2013,532,Elms,11,8,2,21
2013,1068,Elon,15,5,2,22
2013,214,Emerson,10,8,0,18
2013,215,Emmanuel (MA),4,12,2,18
2013,217,Emory,11,7,2,20
2013,216,Emory & Henry,2,14,3,19
2013,8981,Endicott,9,8,5,22
2013,1072,Erskine,8,6,4,18
2013,218,Eureka,2,13,0,15
2013,219,Evansville,9,8,1,18
2013,220,Fairfield,7,8,1,16
2013,222,Fairleigh Dickinson,11,6,6,23
2013,27892,Farmingdale St.,8,9,2,19
2013,221,FDU-Florham,10,11,0,21
2013,23157,Felician,4,11,2,17
2013,225,Ferrum,7,9,3,19
2013,1079,Findlay,6,9,1,16
2013,30032,Finlandia,4,12,0,16
2013,227,Fitchburg St.,5,11,2,18
2013,231,FIU,8,8,2,18
2013,229,Fla. Atlantic,2,13,1,16
2013,28755,FGCU,11,5,3,19
2013,233,Fla. Southern,2,12,2,16
2013,30092,Flagler,10,5,4,19
2013,230,Florida Tech,10,4,3,17
2013,11538,Fontbonne,12,6,2,20
2013,236,Fordham,6,7,4,17
2013,9011,Fort Hays St.,11,6,2,19
2013,1083,Fort Lewis,9,8,2,19
2013,238,Framingham St.,9,6,3,18
2013,1085,Francis Marion,5,9,2,16
2013,30069,Franciscan,1,16,0,17
2013,239,Frank. & Marsh.,12,6,0,18
2013,2694,Franklin,6,9,3,18
2013,241,Franklin Pierce,11,6,2,19
2013,242,Fredonia St.,5,13,1,19
2013,243,Frostburg St.,12,3,4,19
2013,244,Furman,12,4,3,19
2013,253,Ga. Southern,6,12,1,19
2013,1097,Ga. Southwestern,2,14,1,17
2013,245,Gallaudet,3,13,0,16
2013,246,Gannon,13,6,0,19
2013,1092,Gardner-Webb,4,14,2,20
2013,30084,Geneva,9,7,5,21
2013,1094,George Fox,2,16,1,19
2013,248,George Mason,11,6,2,19
2013,249,George Washington,5,13,0,18
2013,251,Georgetown,19,4,3,26
2013,254,Georgia St.,6,12,0,18
2013,258,Gettysburg,6,10,1,17
2013,8366,Goldey-Beacom,4,14,0,18
2013,260,Gonzaga,4,14,1,19
2013,1099,Gordon,6,12,1,19
2013,1467,Goucher,5,10,1,16
2013,1104,Grand Canyon,15,3,2,20
2013,794,Green Bay,2,10,4,16
2013,11062,Green Mountain,3,12,0,15
2013,263,Greensboro,11,5,4,20
2013,1111,Greenville,10,6,3,19
2013,264,Grinnell,9,8,1,18
2013,265,Grove City,8,9,2,19
2013,1112,Guilford,10,8,0,18
2013,266,Gust. Adolphus,15,2,3,20
2013,12399,Gwynedd Mercy,6,12,2,20
2013,267,Hamilton,4,8,2,14
2013,268,Hamline,3,12,3,18
2013,269,Hampden-Sydney,6,11,0,17
2013,1115,Hanover,7,7,4,18
2013,271,Hardin-Simmons,10,6,2,18
2013,1116,Harding,4,11,3,18
2013,272,Hartford,7,9,1,17
2013,273,Hartwick,5,10,2,17
2013,275,Harvard,3,11,3,17
2013,276,Haverford,12,8,1,21
2013,2697,Hawaii Hilo,5,8,2,15
2013,2696,Hawaii Pacific,8,6,3,17
2013,278,Heidelberg,10,7,3,20
2013,1124,Hendrix,10,6,3,19
2013,19651,High Point,12,5,3,20
2013,8398,Hilbert,7,9,1,17
2013,281,Hiram,15,3,1,19
2013,282,Hobart,10,6,0,16
2013,283,Hofstra,11,6,4,21
2013,285,Holy Cross,5,10,2,17
2013,1126,Holy Family,8,7,3,18
2013,8404,Hood,4,10,2,16
2013,286,Hope,12,8,0,20
2013,30160,Houghton,9,5,4,18
2013,287,Houston Baptist,4,10,2,16
2013,290,Howard,3,15,1,19
2013,2741,Howard Payne,4,10,2,16
2013,292,Hunter,2,14,2,18
2013,1130,Huntingdon,6,10,2,18
2013,1133,Husson,15,6,1,22
2013,300,Ill. Wesleyan,11,6,0,17
2013,302,Ill.-Chicago,7,8,2,17
2013,30050,Ill.-Springfield,3,14,1,18
2013,297,Illinois Col.,7,8,3,18
2013,303,Immaculata,3,11,2,16
2013,2743,Incarnate Word,15,4,1,20
2013,306,Indiana,16,5,3,24
2013,309,Indianapolis,7,8,3,18
2013,310,Iona,7,11,0,18
2013,308,IPFW,4,15,1,20
2013,313,Ithaca,7,5,6,18
2013,2699,IUPUI,6,10,2,18
2013,316,Jacksonville,4,13,1,18
2013,317,James Madison,9,7,3,19
2013,320,John Carroll,10,7,3,20
2013,321,John Jay,6,10,3,19
2013,322,Johns Hopkins,8,8,2,18
2013,22626,Johnson & Wales (RI),11,7,2,20
2013,324,Johnson St.,1,16,0,17
2013,325,Juniata,9,9,0,18
2013,326,Kalamazoo,11,7,1,19
2013,329,Kean,9,11,0,20
2013,330,Keene St.,11,7,1,19
2013,334,Kentucky,10,9,2,21
2013,335,Kenyon,9,6,3,18
2013,1159,Keuka,7,8,0,15
2013,30047,Keystone,5,11,0,16
2013,30051,King (TN),3,14,0,17
2013,336,King's (PA),10,6,2,18
2013,337,Knox,6,9,2,17
2013,333,Ky. Wesleyan,0,18,0,18
2013,1163,La Roche,9,10,0,19
2013,340,La Salle,10,7,3,20
2013,341,La Verne,7,11,2,20
2013,342,Lafayette,9,8,4,21
2013,1162,LaGrange,2,14,0,16
2013,2746,Lake Erie,6,12,0,18
2013,344,Lake Forest,15,4,1,20
2013,1164,Lakeland,2,14,3,19
2013,30085,Lancaster Bible,4,10,3,17
2013,1167,Lander,12,3,2,17
2013,8486,Lasell,15,4,1,20
2013,348,Lawrence,8,8,1,17
2013,349,Le Moyne,7,9,1,17
2013,351,Lebanon Valley,14,6,2,22
2013,13302,Lees-McRae,3,11,3,17
2013,352,Lehigh,4,12,1,17
2013,279,Lehman,4,13,2,19
2013,1170,Lenoir-Rhyne,6,7,4,17
2013,24317,Lesley,12,6,2,20
2013,8490,LeTourneau,3,13,1,17
2013,354,Lewis,9,9,0,18
2013,355,Liberty,8,7,3,18
2013,1174,Limestone,13,5,1,19
2013,1176,Lincoln Memorial,13,4,1,18
2013,30136,Lindenwood (MO),15,2,3,20
2013,1179,Linfield,7,11,0,18
2013,28600,Lipscomb,7,12,1,20
2013,360,Lock Haven,6,10,1,17
2013,361,LIU Brooklyn,2,14,2,18
2013,363,Longwood,3,12,3,18
2013,364,Loras,23,2,1,26
2013,1182,Louisiana Col.,7,8,2,17
2013,367,Louisville,14,6,1,21
2013,371,Loyola Chicago,5,12,2,19
2013,369,Loyola Maryland,13,6,1,20
2013,370,Loyola Marymount,6,10,4,20
2013,372,Luther,10,6,2,18
2013,373,Lycoming,4,10,2,16
2013,374,Lynchburg,7,7,4,18
2013,30065,Lyndon St.,4,14,0,18
2013,20794,Lynn,20,2,1,23
2013,376,Macalester,4,13,1,18
2013,377,MacMurray,5,12,1,18
2013,378,Maine Maritime,10,8,0,18
2013,1192,Manchester,5,13,1,19
2013,381,Manhattan,3,12,1,16
2013,382,Manhattanville,8,7,4,19
2013,1194,Maranatha Baptist,8,11,1,20
2013,1196,Marian (WI),3,9,6,18
2013,385,Marietta,4,13,0,17
2013,386,Marist,5,10,1,16
2013,387,Marquette,16,4,1,21
2013,1199,Mars Hill,14,3,3,20
2013,388,Marshall,11,5,1,17
2013,8597,Martin Luther,3,15,0,18
2013,30075,Mary,5,10,3,18
2013,1203,Mary Hardin-Baylor,10,6,1,17
2013,390,Mary Washington,12,8,1,21
2013,392,Maryland,20,1,3,24
2013,394,Marymount (VA),3,12,2,17
2013,395,Maryville (MO),3,15,0,18
2013,396,Maryville (TN),4,11,3,18
2013,397,Marywood,12,7,3,22
2013,486,MCLA,5,10,0,15
2013,399,Mass. Maritime,6,9,2,17
2013,401,UMass Boston,5,10,2,17
2013,656,UMass Dartmouth,12,7,0,19
2013,368,UMass Lowell,14,6,1,21
2013,400,Massachusetts,5,11,2,18
2013,773,McDaniel,6,10,1,17
2013,8530,McMurry,8,12,0,20
2013,379,Me.-Farmington,2,15,0,17
2013,30040,Me.-Presque Isle,5,9,0,14
2013,23725,Medaille,17,3,0,20
2013,403,Medgar Evers,1,14,0,15
2013,404,Memphis,8,7,3,18
2013,406,Mercer,11,7,2,20
2013,724,Merchant Marine,7,8,0,15
2013,407,Mercy,10,5,3,18
2013,408,Mercyhurst,17,6,1,24
2013,410,Merrimack,15,4,2,21
2013,11416,Colorado Mesa,8,7,4,19
2013,411,Messiah,23,0,2,25
2013,412,Methodist,15,3,3,21
2013,413,Metro St.,12,7,1,20
2013,418,Michigan,11,10,1,22
2013,416,Michigan St.,12,10,1,23
2013,420,Middlebury,6,7,1,14
2013,1222,Midwestern St.,10,2,5,17
2013,423,Millersville,9,9,1,19
2013,424,Millikin,5,12,0,17
2013,426,Millsaps,6,9,3,18
2013,797,Milwaukee,8,8,2,18
2013,20220,MSOE,14,5,1,20
2013,1226,Minn.-Morris,12,8,2,22
2013,16142,Misericordia,13,6,3,22
2013,429,Mississippi Col.,13,5,3,21
2013,435,Missouri S&T,8,6,2,16
2013,669,Missouri St.,5,8,4,17
2013,398,MIT,13,5,2,20
2013,30042,Mitchell,7,8,0,15
2013,436,Mo.-St. Louis,12,7,1,20
2013,437,Molloy,7,10,0,17
2013,439,Monmouth,11,4,4,19
2013,438,Monmouth (IL),3,13,1,17
2013,205,Mont. St. Billings,11,5,2,18
2013,442,Montclair St.,19,3,1,23
2013,1238,Montevallo,13,5,2,20
2013,443,Moravian,5,11,1,17
2013,30067,Morrisville St.,15,5,1,21
2013,27901,Mount Ida,6,11,1,18
2013,1245,Mount Olive,6,9,4,19
2013,452,Mount Union,4,8,4,16
2013,30036,Mt. Aloysius,3,14,0,17
2013,8567,Mt. St. Joseph,4,12,1,17
2013,1468,Mt. St. Mary (NY),11,9,1,21
2013,450,Mt. St. Mary's,4,12,1,17
2013,451,Mt. St. Vincent,2,10,1,13
2013,453,Muhlenberg,11,5,0,16
2013,455,Muskingum,5,11,3,19
2013,491,N.C. Wesleyan,9,3,3,15
2013,726,Navy,7,7,3,17
2013,461,Nazareth,7,9,0,16
2013,462,Neb. Wesleyan,8,7,3,18
2013,464,Omaha,5,10,1,16
2013,1254,Neumann,12,7,3,22
2013,467,New England Col.,12,5,3,20
2013,469,New Hampshire,7,7,6,20
2013,470,New Haven,6,9,2,17
2013,319,New Jersey City,11,10,1,22
2013,473,New Mexico,17,4,1,22
2013,475,SUNY New Paltz,11,8,1,20
2013,479,New York U.,12,7,2,21
2013,1257,Newberry,4,11,1,16
2013,21772,Newbury,4,11,2,17
2013,30054,Newman,6,11,1,18
2013,482,Niagara,13,2,4,19
2013,484,Nichols,13,8,0,21
2013,471,NJIT,10,9,0,19
2013,457,North Carolina,16,4,3,23
2013,490,North Carolina St.,10,10,0,20
2013,492,North Central (IL),11,7,0,18
2013,30039,North Central (MN),8,12,1,21
2013,2711,North Florida,4,13,0,17
2013,30052,North Georgia,7,7,2,16
2013,9223,North Greenville,6,8,1,15
2013,496,North Park,13,3,5,21
2013,500,Northeastern,14,3,4,21
2013,12810,Northeastern St.,13,5,3,21
2013,503,Northern Ill.,7,10,3,20
2013,505,Northern Ky.,7,10,1,18
2013,1267,Northland,0,19,1,20
2013,1274,Northwest Nazarene,9,4,5,18
2013,509,Northwestern,13,6,4,23
2013,30031,Northwestern-St. Paul,10,8,3,21
2013,510,Northwood (MI),10,7,1,18
2013,511,Norwich,11,5,4,20
2013,513,Notre Dame,17,4,1,22
2013,30056,Notre Dame de Namur,13,5,1,19
2013,24639,Nova Southeastern,6,9,1,16
2013,1277,Nyack,9,9,2,20
2013,477,NYIT,9,7,3,19
2013,514,Oakland,11,7,1,19
2013,1278,Oakland City,10,6,0,16
2013,515,Oberlin,9,7,1,17
2013,516,Occidental,9,8,0,17
2013,2713,Oglethorpe,9,7,0,16
2013,517,Ohio Northern,25,3,0,28
2013,518,Ohio St.,6,10,3,19
2013,15207,Ohio Valley,0,16,0,16
2013,520,Ohio Wesleyan,13,3,5,21
2013,523,Old Dominion,11,3,3,17
2013,524,Old Westbury,5,14,0,19
2013,525,Olivet,16,5,1,22
2013,526,SUNY Oneonta,14,5,2,21
2013,527,Oral Roberts,4,13,0,17
2013,528,Oregon St.,6,9,3,18
2013,530,Oswego St.,4,10,1,15
2013,531,Otterbein,6,8,3,17
2013,1289,Ouachita Baptist,7,10,0,17
2013,23008,Ozarks (AR),4,10,1,15
2013,2751,Pacific (OR),5,14,0,19
2013,1297,Pacific Lutheran,10,7,2,19
2013,30045,Palm Beach Atl.,15,5,0,20
2013,540,Penn,3,13,0,16
2013,539,Penn St.,9,5,3,17
2013,30114,Penn St.-Abington,12,5,0,17
2013,25719,Penn St.-Altoona,9,8,0,17
2013,538,Penn St.-Behrend,17,5,0,22
2013,30044,Penn St.-Berks,3,14,1,18
2013,30081,Penn St. Harrisburg,9,9,2,20
2013,542,Pfeiffer,1,15,2,18
2013,1305,Cairn,6,11,3,20
2013,543,Philadelphia U.,9,6,4,19
2013,21830,Piedmont,6,10,2,18
2013,1315,Pitt.-Bradford,3,14,0,17
2013,11839,Pitt.-Greensburg,11,6,1,18
2013,546,Pitt.-Johnstown,1,14,1,16
2013,545,Pittsburgh,6,9,2,17
2013,547,Plattsburgh St.,17,3,1,21
2013,548,Plymouth St.,7,11,0,18
2013,481,Polytechnic (NY),9,11,1,21
2013,549,Pomona-Pitzer,14,5,1,20
2013,551,Portland,7,9,3,19
2013,1318,Post,13,4,5,22
2013,1320,Presbyterian,4,16,0,20
2013,30034,Presentation,1,12,0,13
2013,554,Princeton,8,6,2,16
2013,555,Principia,5,14,1,20
2013,556,Providence,4,10,2,16
2013,557,Puget Sound,12,3,5,20
2013,30029,Purchase St.,6,8,1,15
2013,11504,Queens (NC),7,11,1,19
2013,560,Queens (NY),7,6,4,17
2013,561,Quincy,12,2,6,20
2013,562,Quinnipiac,10,5,3,18
2013,563,Radford,10,6,4,20
2013,564,Ramapo,8,9,1,18
2013,566,Randolph,9,7,3,19
2013,565,Randolph-Macon,2,12,3,17
2013,567,Redlands,12,6,3,21
2013,568,Regis (CO),17,2,1,20
2013,569,Regis (MA),8,11,0,19
2013,570,Rensselaer,10,6,6,22
2013,572,Rhode Island,4,11,3,18
2013,571,Rhode Island Col.,4,13,1,18
2013,573,Rhodes,4,11,2,17
2013,681,Richard Stockton,12,7,3,22
2013,575,Richmond,6,11,1,18
2013,576,Rider,3,13,1,17
2013,577,Ripon,6,11,1,18
2013,18422,Rivier,0,14,1,15
2013,578,Roanoke,13,5,1,19
2013,579,Robert Morris,5,12,2,19
2013,30150,Roberts Wesleyan,12,9,1,22
2013,581,Rochester (NY),10,4,4,18
2013,580,Rochester Inst.,9,7,1,17
2013,582,Rockford,2,16,1,19
2013,1328,Rockhurst,18,3,2,23
2013,583,Roger Williams,17,5,1,23
2013,584,Rollins,15,4,2,21
2013,585,Rose-Hulman,12,5,3,20
2013,15882,Rosemont,11,8,1,20
2013,259,Rowan,12,8,2,22
2013,587,Rutgers,7,7,1,15
2013,588,Rutgers-Camden,17,2,3,22
2013,589,Rutgers-Newark,14,8,1,23
2013,11276,S.C. Aiken,6,6,6,18
2013,10411,USC Upstate,5,10,2,17
2013,102,Sacramento St.,8,8,2,18
2013,590,Sacred Heart,9,8,0,17
2013,11036,Sage Colleges,14,5,1,20
2013,591,Saginaw Valley,18,3,4,25
2013,19117,Salem Int'l,9,6,0,15
2013,621,Salem St.,11,7,1,19
2013,622,Salisbury,9,7,2,18
2013,623,Salve Regina,16,6,1,23
2013,627,San Diego,14,9,0,23
2013,626,San Diego St.,7,9,3,19
2013,628,San Fran. St.,4,10,4,18
2013,629,San Francisco,6,7,5,18
2013,630,San Jose St.,8,9,1,18
2013,631,Santa Clara,11,6,2,19
2013,1355,Schreiner,8,10,0,18
2013,633,Scranton,17,3,2,22
2013,1356,Seattle,3,13,1,17
2013,634,Seattle Pacific,11,3,5,19
2013,635,Seton Hall,6,12,0,18
2013,30063,Seton Hill,4,13,2,19
2013,652,Sewanee,4,12,3,19
2013,637,Shenandoah,3,13,2,18
2013,10870,Shepherd,9,9,1,19
2013,638,Shippensburg,5,9,2,16
2013,30151,Shorter,4,13,1,18
2013,639,Siena,10,7,0,17
2013,641,Simpson,13,8,1,22
2013,660,SIUE,13,7,0,20
2013,642,Skidmore,10,5,2,17
2013,643,Slippery Rock,11,4,6,21
2013,663,SMU,10,5,5,20
2013,645,Sonoma St.,8,8,2,18
2013,648,South Carolina,5,11,2,18
2013,651,South Fla.,8,6,5,19
2013,658,Southern Conn. St.,8,7,1,16
2013,661,Southern Ind.,11,7,0,18
2013,662,Southern Me.,5,13,0,18
2013,468,Southern N.H.,19,4,0,23
2013,1379,Southern Vt.,3,14,0,17
2013,2755,Southwest Baptist,3,12,1,16
2013,8746,Southwestern (TX),13,8,2,23
2013,23260,Spalding,6,10,2,18
2013,673,Springfield,8,10,2,20
2013,593,St. Anselm,5,10,2,17
2013,596,St. Bonaventure,5,14,0,19
2013,1334,St. Edward's,12,3,3,18
2013,599,St. Francis Brooklyn,7,10,1,18
2013,600,Saint Francis (PA),6,7,7,20
2013,601,St. John Fisher,10,5,3,18
2013,602,Saint John's (MN),9,6,4,19
2013,603,St. John's (NY),10,5,4,19
2013,606,Saint Joseph's,5,11,2,18
2013,30072,St. Joseph's (Brkln),3,10,0,13
2013,604,St. Joseph's (IN),5,11,1,17
2013,1340,St. Joseph's (L.I.),13,10,0,23
2013,605,St. Joseph's (ME),10,7,2,19
2013,607,St. Lawrence,14,3,3,20
2013,608,Saint Leo,7,8,1,16
2013,609,Saint Louis,16,5,0,21
2013,1343,Saint Martin's,3,15,0,18
2013,610,St. Mary's (CA),9,5,5,19
2013,611,St. Mary's (MD),4,13,0,17
2013,612,Saint Mary's (MN),7,10,1,18
2013,1346,St. Mary's (TX),5,11,1,17
2013,613,Saint Michael's,6,6,5,17
2013,614,St. Norbert,8,7,3,18
2013,615,St. Olaf,11,6,1,18
2013,617,Saint Peter's,5,11,0,16
2013,1347,Saint Rose,1,15,0,16
2013,618,St. Scholastica,18,5,0,23
2013,620,St. Thomas (MN),11,5,3,19
2013,1348,St. Thomas Aquinas,5,5,5,15
2013,30064,Saint Vincent,6,11,1,18
2013,674,Stanford,9,8,1,18
2013,675,Staten Island,11,11,1,23
2013,678,Stetson,3,10,2,15
2013,679,Stevens,18,3,1,22
2013,21852,Stevenson,8,10,1,19
2013,682,Stonehill,5,11,1,17
2013,683,Stony Brook,11,6,1,18
2013,684,Suffolk,7,10,1,18
2013,168,SUNY Cortland,9,8,1,18
2013,247,SUNY Geneseo,6,10,2,18
2013,478,SUNY Maritime,8,12,1,21
2013,552,SUNY Potsdam,4,9,4,17
2013,9500,SUNYIT,9,7,2,18
2013,685,Susquehanna,18,3,1,22
2013,686,Swarthmore,16,3,2,21
2013,688,Syracuse,14,6,1,21
2013,689,Tampa,10,6,1,17
2013,712,TCNJ,7,11,0,18
2013,690,Temple,10,6,3,19
2013,30090,Tex. A&M Int'l,10,4,4,18
2013,30088,Tex. Permian Basin,6,12,0,18
2013,1400,Texas Lutheran,6,8,2,16
2013,23121,Texas-Dallas,12,5,1,18
2013,30028,Texas-Tyler,11,6,1,18
2013,707,Thiel,4,12,2,18
2013,2758,Thomas (ME),15,3,2,20
2013,1402,Thomas More,13,4,4,21
2013,1403,Tiffin,5,9,2,16
2013,711,Towson,4,10,2,16
2013,28749,Transylvania,16,2,2,20
2013,30037,Trine,8,10,1,19
2013,713,Trinity (CT),5,6,4,15
2013,715,Trinity (TX),19,1,4,24
2013,499,Truman,10,6,1,17
2013,717,Tufts,9,4,4,17
2013,719,Tulsa,14,6,1,21
2013,12830,Tusculum,7,8,3,18
2013,1255,U New England,6,10,1,17
2013,9,UAB,10,8,2,20
2013,108,UC Davis,10,7,4,21
2013,109,UC Irvine,5,14,1,20
2013,111,UC Riverside,10,8,0,18
2013,112,UC San Diego,9,4,4,17
2013,104,UC Santa Barbara,10,6,3,19
2013,113,UC Santa Cruz,7,9,2,18
2013,9754,UC-Colo. Springs,9,9,1,19
2013,128,UCF,8,7,3,18
2013,110,UCLA,13,3,3,19
2013,391,UMBC,11,4,7,22
2013,2707,UMKC,7,10,2,19
2013,456,UNC Asheville,1,15,1,17
2013,459,UNC Greensboro,5,10,2,17
2013,537,UNC Pembroke,12,5,2,19
2013,460,UNC Wilmington,7,11,1,19
2013,727,Union (NY),12,5,0,17
2013,465,UNLV,6,14,1,21
2013,728,Upper Iowa,3,13,0,16
2013,730,Ursinus,5,12,0,17
2013,733,Utica,8,8,2,18
2013,745,Va. Wesleyan,8,10,2,20
2013,735,Valparaiso,6,9,5,20
2013,737,Vassar,13,5,3,21
2013,740,VCU,12,4,5,21
2013,738,Vermont,8,5,5,18
2013,739,Villanova,12,6,2,20
2013,746,Virginia,10,7,4,21
2013,742,Virginia Tech,7,10,3,20
2013,741,VMI,2,14,1,17
2013,747,Wabash,4,14,0,18
2013,749,Wake Forest,11,4,5,20
2013,30141,Walsh,3,13,0,16
2013,750,Wartburg,7,9,2,18
2013,751,Wash. & Jeff.,6,7,3,16
2013,752,Wash. & Lee,11,4,3,18
2013,756,Washington,13,5,3,21
2013,1029,Washington Adventist,3,8,2,13
2013,753,Washington Col.,5,10,0,15
2013,755,Washington-St. Louis,10,5,2,17
2013,1434,Waynesburg,8,8,1,17
2013,759,Webster,12,6,2,20
2013,761,Wells,8,8,0,16
2013,762,Wentworth,1,11,4,16
2013,763,Wesley,5,11,2,18
2013,764,Wesleyan (CT),9,4,4,17
2013,358,West Ala.,12,7,0,19
2013,765,West Chester,8,8,2,18
2013,11740,West Florida,12,3,2,17
2013,767,West Tex. A&M,11,4,2,17
2013,9630,West Va. Wesleyan,13,5,1,19
2013,768,West Virginia,9,6,2,17
2013,770,Western Conn. St.,3,12,2,17
2013,771,Western Ill.,7,9,5,21
2013,774,Western Mich.,11,6,2,19
2013,775,Western New Eng.,9,9,3,21
2013,1448,Western Wash.,8,8,2,18
2013,777,Westfield St.,9,10,2,21
2013,1450,Westminster (MO),10,7,2,19
2013,1451,Westminster (PA),11,6,2,19
2013,778,Wheaton (IL),18,4,3,25
2013,779,Wheaton (MA),9,7,4,20
2013,12799,Wheeling Jesuit,11,8,0,19
2013,8896,Wheelock,0,3,0,3
2013,780,Whitman,8,8,4,20
2013,781,Whittier,10,12,0,22
2013,1454,Whitworth,13,3,3,19
2013,783,Widener,7,9,2,18
2013,784,Wilkes,5,10,2,17
2013,785,Willamette,10,7,2,19
2013,786,William & Mary,4,10,4,18
2013,789,Williams,16,2,4,22
2013,1460,Wilmington (DE),12,8,0,20
2013,1461,Wilmington (OH),10,8,1,19
2013,1462,Wingate,13,6,1,20
2013,792,Winthrop,12,9,2,23
2013,8911,Wis. Lutheran,11,9,0,20
2013,798,Wis.-Oshkosh,9,5,3,17
2013,799,Wis.-Parkside,6,10,1,17
2013,800,Wis.-Platteville,15,4,2,21
2013,804,Wis.-Superior,12,6,2,20
2013,805,Wis.-Whitewater,8,5,3,16
2013,796,Wisconsin,6,8,5,19
2013,806,Wittenberg,5,11,2,18
2013,787,Wm. Paterson,8,9,1,18
2013,2915,Wofford,10,9,2,21
2013,807,Wooster,4,12,1,17
2013,809,Worcester St.,4,11,2,17
2013,808,WPI,11,5,0,16
2013,810,Wright St.,4,13,1,18
2013,812,Xavier,14,3,5,22
2013,813,Yale,4,8,5,17
2013,814,Yeshiva,3,8,0,11
2013,2730,York (NY),4,11,1,16
2013,815,York (PA),18,2,4,24
